__##################
_##############^^###
_###############^###
_######^^###########
_######^^^^^########
_#######^^^^^#######
_#######^^^^^^######
_########^^^^^######
_#########^^^^^#####
_##########^^^^#####
_############^######
__##############_###
___#############__##
______##########__##
__________#######_##